%%%%%%%%%%
%G   P  .%
%%%%%%%%%%
