%%%%%%%
% P   %
% %%% %
% %.  %
% %%% %
%G G  %
%%%%%%%
